NO ./textures/1.xpm
SO ./textures/2.xpm
WE ./textures/3.xpm
EA ./textures/4.xpm

F 220,100,0
C 240,188,255

        1111111111111111111111111
        1000000000110000000000001
        1011000001110000000000001
        1001000000000000000000001
111111111011000001110000000000001
100000000011000001111111111001111
111101111111110111000000100001
111101111111110111010100100001
110000001101010111000000100001
100000000000000011000000100001
100000000000000011010100100001
110000011101010111110111100E01
11110111 1110101 1011110100001
11111111 1111111 1111111111111
111111111111111111111111111111111111