NO ./textures/4.xpm
WE ./textures/7.xpm
EA ./textures/1.xpm
SO ./textures/6.xpm
C 128,128,255
F 255,255,255

111111111111111111111111111111111111111111111111111111111111
10N000000000000000000000000000000000000000000000000000000001
110000000000000010000001000000100000000011100000000000000001
11000000000000001000000100000010000000001 100000000000000001
11000000000000001000000100000010000000001 100000000000000001
11000000000000001000000100000010000000001 100000000000000001
11000000000000001000000100000010000000001 100000000000000001
11000000000000001000000100000010000000001 100000000000000001
11000000000000001000000100000010000000001 100000000000000001
11000000000000001000000100000010000000001 100000000000000001
11000000000000001000000100000010000000001 100000000000000001
11000000000000001000000100000010000000001 100000000000000001
11000000000000001000000100000010000000001 100000000000000001
11000000000000001000000100000010000000001 100000000000000001
111111111111111111111111111111111110111111111111111111111111