NO ./texts/4.xpm
F 255,255,255
WE ./texts/7.xpm
EA ./texts/1.xpm
C 128,128,255
SO ./texts/6.xpm

111111111111111111111111111111111111111111111111111111111111
10E000000000000000000000000000000000000000000000000000000001
111111111111111111111111111111111110111111111111111111111111
111111111111111111111111111111111110111111111111111111111111
111111111111111111111111111111111110111111111111111111111111
111111111111111111111111111111111110111111111111111111111111
111111111111111111111111111111111110111111111111111111111111
111111111111111111111111111111111110111111111111111111111111
111111111111111111111111111111111110111111111111111111111111
111111111111111111111111111111111110111111111111111111111111
111111111111111111111111111111111110111111111111111111111111
111111111111111111111111111111111110111111111111111111111111
111111111111111111111111111111111110111111111111111111111111
111111111111111111111111111111111110111111111111111111111111
111111111111111111111111111111111110111111111111111111111111